Aaya: este
Ack: ac terminacion por yacko agua
Ackcka: yo
Ack-catchar: perezoso, holgazán, ocio
ack-iu: pluma de ave = ala. cfr na / hacking, as chiqui e iquique
ack-col: conmigo (mecum) cfr / col
ack: me. Pron. personal 1.ps personal sin
Ack-abí: ¡Toma!
Akainu: No, -cfr: sickin
Aksaya: mío (pron. poses)
Aksu: poncho: - rebozo
Ay: en (prep.)
Ay: su, suyo; (colocado al final de una palabra como sufijo)
Aylí: por acá
Ayquina: (debiese ser Ay-ckina) anexo de la parroquia de calama
Aiss: Aquí (tal vez por ahí)
Aytia: Pecho
Aytzir: Vizcacha
Ay-ián: moza, mujer núbil
Almi-ia: camisa
Am-mu: dueño, patrón
Ampatur: un sapo de especie particular
Anatán: esta noche (adverb)
Anck-si: recién (adverb)
Anuckápin: hoy dia (adverb) (anu i ckapin)
Anu: ahora, hoy
Anta: este
Antap-tarde: esta tarde (adverb.)
Ao: terminación de al nombre de lugar: v.g toconao
Aps: ese
Apus: harina tostada
Ap-ps: acá
Ara: por Hara : -alojamiento
Arackar: osamenta
Arizaro: salar de la cordillera, via atacama
Aro: cfr: ara
Aschiqui: apellido de chiu-chiu
Asnu: también asno: asno, burro
Astatur: azotar
Atacama: cabecera de la parroquia de su nombre
Atán: noche: cfr: ttulti
Atas-cka: maíz decorticado
Atchi: negro, color oscuro - en combinación= 1° latchiratchi, zorzal, pájaro negro . 2°
aschiqui: apellido de chiu-chiu en 1612. Debiera escribirse 
atchi-hackiu: pluma negra (
Generalmente los apellidos atacameños están muy mal ortografiados en los libros
parroquiales, tanto de Chiu-chiu como Atacama. - 3° 
atchimitchi: gato montés, literalmente
gato negro, este animal tiene efectivamente fajas negras en el cuerpo. - Podría darse otra
etimolojía sacada de kaytchi, peñas y mitchi gato de las peñas - pero es menos problable que
la anterior
At-halpa: gallina
Atitchaus: poder
Atitur: poder más, vencer
Atiu: oeste. cfr: ckapin y ladia
Atta: ayer
Au: cfr a, ar, ara
Aulo: abuelo, es el termino cast. mal pronunciado
Ay: apellido de 1615, mal ortografiado por ay-i
Ay-i: maíz
Ay-yan: desagradable
Aychil: apellido de 1612. Tal vez sea mala transcripción de aytzir: viscacha

Baalatur: cavar
Baalsatur: barrer
Baanscki: tal vez (adverbio) 
Baasnatur: descargar (asnatur, contiene la voz asnu)
Back-cka: ribera, rio, hoya, llanura/ cfr ckantu/ cfr tarapaca
Backa-psladis: sur (compuesto de back-cka i lado, costado, en castellano)
Backatur: embarrar, designa también el acto de peinarse para lo cual usan en Atacama un barro alcalino formado con tierra que se recoje a las orillas de algunas lagunas de la cordillera y sirve para lavar la cabeza. cfr: laumatur
Backaratur: rascar
Backiti: descuellado / tchocklo
Backnitur: sentarse, cabalgar, motar a caballo
Backra: asta, cuerno
Backs: abajo: tal vez es corrupc. del castellano
Backtcha: pobre, i por estension, huérfano
Bailatur: payar
Bailitur: halagar con los ojos
Baina: querido, mancebo 
Baini: todo
Balsantur: escoba / cfr baalsatur
Baltchar: malo, desgracia, asesinato
Baltatur: trillar. cfr: hockuntur
Balt-hitur: correr
Bañuncki: trillar / cfr hockuntur
Barainir: resbaloso
Baratur: friega
Batckatur: escuchar
Bat-tar: era para trillar
Bé: si /cfr ickiare
Becknatur: morder
Becktchi: podrido / cfr ckaimainir llagas venéreas
Beckuntur: acompañar
Beluinatur: colgar
Berinatur: temblar
Bestatur: ladear
Besti: torcido, chueco
Beter: camino / llámese así un ay-llo de Atacama (escribese a veces peter y pete)
Beu-nitur: espantar
Bicki: parecido
Bickutar: gallareta, ave acuática que vive en los rios y lagunas atacameñas
Bilti: halcon
Birbintur: espolvorear
Bircke: fondo hecho de barro
Birinatur: arroyo
Bitainatur: arroyo
Bitchackma: pellizcar
Bitis: pómulos
Ckaabar: traje, vestido
Ckaabartantur: vestirse
Ckaacka: tartamudo
Cka-acks: en frente!
Ckaala: amarilla (escríbese también ckalal)
Ckaapin: dia - designa también al sol
Ckaapir: zurdo
Ckaari: verde
Ckaaya: bueno
Ckabaltun: estiércol de animales 
Ckabar: ropa
Ckabatur: esconder
Ckabi: apellido de 1613 - lugar de cordillera, via Antofagasta de la sierra
Ckabur: cerro elevado
Ckabutur: lavarse
Ckabuy: apellido de 1613
Ckacka: frente
Ckackar: ancho, amplitud
Ckackasima: las cejas
Ckackasintur: acostarse de espaldas, boca arriba (lit. frente arriba)
Ckackatur: abrir (cfr, ckastur)
Ckackma: cucaracho
Ckacknatur: saborear
Ckacktchi: pescado ( para los changos, cuyo alimento casi exclusivamente era el pescado, secomprende que el termino escojido para designarlo haya sido, ckacktchi, que significa bueno,agradable =
Ckackchi: Bueno, agradable, sabroso al paladar 
ckacktchir: bueno, agradable, sabroso al paladar (diferénciase de ckaaya, en que
éste no se aplica a los alimentos, sino a cualidades morales, salud etc. aveces designa
pequeñez.)
Cckacktur: beber, pero hasta emborracharse
Ckackuntur: gusto (radical ckacka-cktchi)
Ckaickai: oreja, orejas
Ckaimaiñir: podrido
Ckaipi: Boca, apellido de 1613
Ckair: salado
Ckaitchi: piedra, peña, peñasco, granizo
Ckalal: quebrada, valle estrecho entre dos cerros
Ckalama: Calama
ckalanna: yema
Ckalck-haltur: huero 
Ckalck-nar: golpe
Ckalentata: lascivo
Ckalis: odre
Ckaltcha: escarpines
Ckamai: nieto
Ckamur: luna, mes
Ckamuria-muley: eclipse de luna
Ckan: (cfr, ckani i tchuckut)
Ckanas-cka: goloso
Ckanckapur: Panzón, obeso
Ckanckartur: raspar
Ckanckata: acción de asar
Ckani: vientre (etimol= ckani, vientre i cabur cerro) ni vientre (dícese tambien ckanni) a los habitantes del ayllo de Beter, en Atacama, díceseles= ckantchisckur, vientre áspero, velludo 
Ckannai: amargo
Ckannau: vieja, mujer anciana
Ckantu: orilla
Ckantur: dar
Ckapacka: rico
Ckapar: raíz
Ckapatur: grandote, crecer (radical. ckabur)
Ckapckitur: retar, insultar, hacerse el poderoso (rad. ckabur)
Ckapin: sol (oeste?)
Ckapir: izquierdo
Ckapnatur: coquear, mascar coca, apellido= capniar, 1620
Ckapsuluntur: atorarse (tal vez tragarse la coca)
Ckaptur: cargar a la espalda
Ckapun: (cfr leri)
Ckapur: grande, (cfr ckabur, alto y hondo)
Ckaputur: sobar
Ckarackartur: despedazar, cortar
Ckarama: acción de cortar
Ckaranti: nombre de un lugar cerca de Socaire
Ckarao: costilla
Ckaratchi: viruelas
Ckaratur: cortar, quebrar
Ckarayin: acostarse de lado (cfr ckarao)
Ckari: nuevo, verde
Ckarickstur: escarcha
Ckarisur: peine 
Ckaru: lado, costado
Ckarupstur: astilla
Ckasantur: moler
Ckasmas: apellido de 1616
Ckas: hondanada
Ckasmis: apellido de 1611
Ckaspa: casi, cuasi
Ckaspana: anexo de Chiuchiu (rad. ckas- pana hijo de la hondanada)
Ckas-sa: portillo
Ckastur: abrir (Rad ckas-sa)
Ckatasencul: otra vez, más tarde
Ckatalnatur: aplastar
Ckatat: apellido de 1622
Ckatcha: apestado, enfermo de viruelas
Ckatchacka: áspero, terreno muy pedregoso (Rad ckaitchi)
Ckatchacktur: zafarse
Ckatchatur: trasquilar
Ckatchbi: El
Ckatchcka: cascarañas
Ckatchi: aquel (allí) (también ckatchil por alla / ckatchips id=
Ckatchir: chicha de maíz, dulce
Ckatchi-rutaino: el año pasado
Ckatchirckotch: aquellos
Ckatchunti: hoz
Ckati: piel 
Ckatitchauña: imposible
Ckatir: cuero
Ckatnatur: volver, remangarse, revolverse, descubrirse, desnudarse
Ckatnu: seno
Ckatta: hoja
Ckatu: roca, peña
Ckatur: llamar
Ckatur: cuero
Ckauckaitur: asar
Ckausama: vida
Ckausatur: vivir, resuscitar
Ckautcha: hierba parecida a la malva
Ckauti: huevo
Ckaya: bien, bueno
Ckayaritur: empezar 
Ckayatar: sanar (cfr. ckaya)
Ckai-yi: talón
Cke: muy, mucho
Ckeba: marimacho
Ckebi: aluvion
Ckedúdama: duda
Ckeetchi: encima
Ckeelas: planta o arbusto llamado tambien ckatchi-yuyo
Ckees: medio
Ckeit-tchu: liendre
Ckein-tcha: seco
Ckeitin: techo
Ckelar: brasa, fuego
Ckeleckelte: planta espinuda llamada también candial
Ckeleutch-auña: nunca
Ckeli: silla de montar, también el avío o comida que va colgando de la silla en alforjas
Ckelinar: aire, atmósfera
Ckeltchar: verdad
Ckelti: nervio
Ckeltur: cardo
Ckemptur: usar
Ckénia: diente
Ckenni: uña
Ckentchayacke: destemplar
Ckentchockol: encías 
Ckentur: valor
Ckepar: faja
Ckepe, ckepi: ojo
Ckepininar: mal de ojo, maleficio
Ckepininai: pupila, niña del ojo
Ckepinumar: tuerto
Ckepipu: lágrima
Ckepisinna: pestañas
Ckepitarana: lo blanco del ojo
Ckepnitur: despertar
Ckeppar: cinturon
Ckeptur: sacar
Ckerantur: mascar
Ckersitur: asustar
Ckestur: pararse
Cketchir: huevo de piojo
Cketti: año
Ckeutur: llorar
Ckeu-uy: dientes
Ckibur: hembra
Cki-i: mi, mío
Cki-is: entre (prepos)
Cki-itur: pelear
Ckilapana: aloja, bebida atacameña hecha con algarroba
Ckilir: raton
Ckiltorsocompa: apellido de 1618
Ckintur: roer
Ckipti: cama
Ckiptur: amar, querer
Ckitchcknatur: anudar
Ckira: compuerta
Ckirckir: palomita que abunda en la cordillera
Ckis-tchatur: besar
Ckisti: greda
Ckits: suyo
Ckitche: huevo de piojo
Ckitti: cama
Ckito: arriba
Ckockimbaltir: apellido de 1615
Ckocko: loma
Ckockops: este
Ckockops: atras
Ckocksur: pedo
Ckocku: atras
Ckoiba: cueva
Ckoicktur: alegria, alegrarse, hombrear
Ckoickstur: aborrecer
Ckoi-man: duende, remolino
Ckoimar: ventolera
Ckoimatur: olvidar
Ckoinatur: hilar
Ckoirama: el anochecer, el crepúsculo
Ckoistur: odiar
Ckoitchi: arco íris
Ckoitur: huso
Ckol:co
Ckolackuntur: ensartar
Ckolan: perdiz
Ckolas: acción de ulpear, tomar harina tostada de maíz desleida en agua fria, designa también las 12 del día
Colatur: almorzar
Ckolbacktur: responder, contestar
Ckolckitur: embarazo
Ckolckol: la rótula de la rodilla
Ckoli: tórax
Ckolcktur: caer
Ckoltao: añapa, ingrediente para fabricación de la chicha
Ckolti: cuello de un vestido
Ckomal: garganta
Ckomallechaque: murmurador
Ckomuraimir: ronquera, enronquecido
Ckonatur: temer
Ckonicks: anciano
Ckonni: ántes
Ckonnir: diestra
Ckontor: cóndor
Ckontarhualtir: apellido de 1626
Ckonntur: buscar
Ckonnti: gente
Ckonte: gente
Ckoockops: detras
Ckooli: cuerpo
Ckools: agujero
Ckooyo: cuello
Ckopa: puño, mango
Ckopackotur: corretear
Ckopal: apellido de 1620
Ckopailitti: larva
Ckopi: manco
Ckopiapó: Copiapó
Ckoraitur: mecer
Ckori: gordo
Ckori: cuento, chisme
Ckorin: verdad
Ckorinta: cierto
Ckoritur: engordar
Ckoro: cáscara de huevo
Ckorpintur: deshojar
Ckosckantur: vendar
Ckosckatur: abrigar, tapar
Ckoscko: lechuza
Ckot: suyos
Ckot-ckot: clueca
Ckota: los
Ckotack-saya: mios
Ckontatur: agradecer
Ckotatur: revolcar
Ckotch: la
Ckotchayá: a los
Ckotchí: enfermo
Ckotcho: mazamorra con harina de trigo tostado
Ckot-cko: cráneo
Ckot-ckol: con ellos
Ckot-tar: costura
Ckot-tatur: enfermarse
Contuntur: cabestrear, tirar del cabestro
Ckoiyajne: contento
Ckoi-yi: bordo, estremo
Ckoi: voz
Ckoi-yotur: amarrar
Cko-yu: junto
Ckubi: chinchilla
Ckucks: inútil
Ckuckuntur: silbar
Ckui-tchar: crudo
Ckúlan: cara
Ckuli: descalzo
Ckulub: tobillo
Ckulun: malva
Ckumaynir: paralítico
Ckumi: lático, penca
Ckummi: planta que parece de la familia de las tunas
Ckun: nosotros
Ckunna: nosotros
Ckunabur: espantajo
Ckunatur: temer
Ckunau/ao: miedo
Ckunna: nuestro, nosotros
Ckunnatur: cobarde
Ckunsa: nuestro
Ckuntur: cocer
Ckuppa: hospedaje
Ckúputur: ofrecer (R. ckuppa)
Ckurasa: ollita
Ckuratur: romper
Ckuri: viento
Ckuri: cintura
Ckurius: disentería
Ckuru: leon, puma
Ckuruí-ya: viento
Ckusckatur: abrigarse
Ckusckantur: (cfr ckoyotur)
Ckusso: canilla
Ckustalanau: planta del pié
Ckustur: madurar
Ckussur: médula de los huesos
Ckuta: sal
Ckutchir: pié
Ckutchubi: esquina
Ckutckuntur: salar
Ckutckutí: chinchilla ordinaria- la que llaman vulgarmente hamuscada
Ckutchi: chancho, cochino
Ckutchi: empeine
Ckutchintur: andar a pie
Ckutta: sal
Ckutti: ombligo
Ckutuptur: volcar (cfr. libainatur)
Ckuy-iay: triste
Ckuy-iatur: tener lástima
Ckui-iucur: ruedecita del uso para hilar